12 12 12 12 12 12 12 13 15 15 15 15 15 15 15 15 15 15 15 15 15 15 15 15 15 12 12 12 12 12 12 12 
9 7 0 0 14 0 0 13 15 4 4 4 4 4 4 4 15 4 4 4 4 4 4 4 4 0 0 14 0 0 0 8 
9 0 0 0 14 0 0 13 15 4 15 15 15 15 15 4 15 4 4 4 4 4 4 4 15 0 14 0 0 14 0 8 
9 0 0 0 14 0 0 13 15 4 15 7 4 4 4 4 15 4 4 4 4 4 4 4 15 0 0 0 14 14 14 8 
14 14 14 14 14 0 0 13 15 4 15 15 15 15 15 15 15 4 4 4 4 4 4 4 15 15 15 15 15 15 15 15 
9 0 0 0 0 0 0 13 15 4 15 15 15 15 15 15 15 4 15 15 15 15 15 15 15 15 15 15 15 15 4 15 
9 0 14 14 14 14 14 13 15 4 15 4 4 4 4 4 4 4 4 4 4 4 4 4 4 4 4 4 4 4 4 15 
9 0 0 0 0 0 0 13 15 4 15 4 15 15 15 15 15 15 15 15 15 15 15 15 15 15 15 15 15 15 15 15 
9 0 14 14 14 14 14 13 15 4 15 4 4 4 4 4 4 4 4 4 4 4 4 4 4 4 4 4 4 4 4 15 
9 0 0 0 0 0 0 13 15 4 15 15 15 15 15 15 15 15 15 15 15 15 15 15 15 15 15 15 15 15 4 15 
9 0 14 14 14 14 14 13 15 4 15 4 4 4 4 4 4 4 4 4 4 4 4 4 4 4 4 4 4 4 4 15 
9 0 0 0 0 0 0 4 4 4 15 4 15 15 15 15 15 15 15 15 15 15 15 15 15 15 15 15 15 15 15 15 
9 0 0 0 0 0 0 4 4 4 15 4 4 4 4 4 4 4 4 4 4 4 4 4 4 4 4 4 4 4 4 15 
9 0 14 14 14 14 14 13 15 4 15 15 15 15 15 15 15 15 15 15 15 15 15 15 15 15 15 15 15 15 4 15 
9 0 0 0 0 0 0 13 15 4 15 4 4 4 4 4 4 4 4 4 4 4 4 4 4 4 4 4 4 4 4 15 
9 0 14 14 14 14 14 13 15 4 15 4 15 15 15 15 15 15 15 15 15 15 15 15 15 15 15 15 15 15 15 15 
9 0 0 0 0 0 0 13 15 4 15 4 4 4 4 4 4 4 4 4 4 4 4 4 4 4 4 4 4 4 4 15 
9 0 14 14 14 14 14 13 15 4 15 15 15 15 15 15 15 15 15 15 15 15 15 15 15 15 15 15 15 15 4 15 
9 0 0 0 0 0 0 13 15 4 15 4 4 4 4 4 4 4 4 4 4 4 4 4 4 4 4 4 4 4 4 15 
9 0 0 0 0 0 0 13 15 4 15 4 15 15 15 15 15 15 15 15 15 15 15 15 15 15 15 15 15 15 15 15 
14 0 0 0 0 0 0 13 15 4 15 4 4 4 4 4 4 4 4 4 4 4 4 4 4 4 4 4 4 4 4 15 
9 0 0 0 0 0 0 13 15 4 15 15 15 15 15 15 15 15 15 15 15 15 15 15 15 15 15 15 15 15 4 15 
9 0 0 0 0 0 0 13 15 4 4 4 4 4 4 4 4 4 4 4 4 4 4 4 4 4 4 4 4 4 4 15 
12 12 12 12 12 12 12 13 15 15 15 15 15 15 15 15 15 15 15 15 15 15 15 15 15 15 15 15 15 15 15 15 
