12 12 12 12 15 15 15 15 15 15 15 15 15 15 15 15 15 15 15 15 15 15 15 15 15 15 15 15 15 15 15 15 
9 0 0 0 4 4 15 4 4 4 4 4 4 4 4 4 4 4 4 4 4 4 4 4 4 4 4 4 4 4 4 15 
9 0 0 0 15 4 15 4 15 15 15 15 15 15 15 15 15 15 15 15 15 15 15 15 15 15 15 15 15 15 4 15 
9 0 0 7 15 4 15 4 15 4 4 4 4 4 4 4 4 4 4 4 4 4 4 4 4 4 4 4 4 15 4 15 
15 15 15 15 15 4 15 4 15 4 15 15 15 15 15 15 15 15 15 15 15 15 15 15 15 15 15 15 4 15 4 15 
15 4 4 4 4 4 15 4 15 4 15 4 4 4 4 4 4 4 4 4 4 4 4 4 4 4 4 15 4 15 4 15 
15 4 15 15 15 15 15 4 15 4 15 4 15 15 15 15 15 15 15 15 15 15 15 15 15 15 4 15 4 15 4 15 
15 4 15 4 4 4 4 4 15 4 15 4 15 4 4 4 4 4 4 4 4 4 4 4 4 15 4 15 4 15 4 15 
15 4 15 4 15 15 15 15 15 4 15 4 15 4 15 15 15 15 15 15 15 15 15 15 4 15 4 15 4 15 4 15 
15 4 15 4 15 4 4 4 4 4 15 4 15 4 4 4 4 4 4 4 4 4 4 15 4 15 4 15 4 15 4 15 
15 4 15 4 15 4 15 15 15 15 15 4 15 15 15 15 15 15 15 15 15 15 4 15 4 15 4 15 4 15 4 15 
15 4 15 4 15 4 15 4 4 4 4 4 15 4 4 4 4 4 4 4 4 4 4 15 4 15 4 15 4 15 4 15 
15 4 15 4 15 4 15 4 15 15 15 15 15 16 15 15 15 15 15 15 15 15 15 15 4 15 4 15 4 15 4 15 
15 4 15 4 15 4 15 4 15 29 2 2 2 2 2 2 2 2 2 2 2 2 2 15 4 15 4 15 4 15 4 15 
15 4 15 4 15 4 15 4 15 2 2 2 2 2 2 2 2 2 2 2 2 2 2 15 4 15 4 15 4 15 4 15 
15 4 15 4 15 4 15 4 15 15 15 15 15 15 15 15 15 15 15 15 15 15 15 15 4 15 4 15 4 15 4 15 
15 4 15 4 15 4 15 4 4 4 4 4 4 4 4 4 4 4 4 4 4 4 4 4 4 15 4 15 4 15 4 15 
15 4 15 4 15 4 15 15 15 15 15 15 15 15 15 15 15 15 15 15 15 15 15 15 15 15 4 15 4 15 4 15 
15 4 15 4 15 4 4 4 4 4 4 4 4 4 4 4 4 4 4 4 4 4 4 4 4 4 4 15 4 15 4 15 
15 4 15 4 15 15 15 15 15 15 15 15 15 15 15 15 15 15 15 15 15 15 15 15 15 15 15 15 4 15 4 15 
15 4 15 4 4 4 4 4 4 4 4 4 4 4 4 4 4 4 4 4 4 4 4 4 4 4 4 4 4 15 4 15 
15 4 15 15 15 15 15 15 15 15 15 15 15 15 15 15 15 15 15 15 15 15 15 15 15 15 15 15 15 15 4 15 
15 4 4 4 4 4 4 4 4 4 4 4 4 4 4 4 4 4 4 4 4 4 4 4 4 4 4 4 4 4 4 15 
15 15 15 15 15 15 15 15 15 15 15 15 15 15 15 15 15 15 15 15 15 15 15 15 15 15 15 15 15 15 15 15 
