12 12 12 12 12 12 12 12 12 12 12 12 12 12 12 12 12 12 12 12 12 12 12 12 12 12 12 12 12 12 12 12 
9 0 14 0 0 0 0 14 0 0 0 0 0 0 0 0 0 14 0 0 0 0 0 0 14 0 0 0 14 0 0 8 
9 0 14 14 0 14 0 14 0 14 14 14 14 14 14 14 0 14 0 0 0 0 0 0 14 0 0 0 14 0 0 8 
14 14 14 14 0 14 0 14 0 14 0 0 0 0 0 0 0 14 0 0 0 0 0 0 0 0 0 0 14 0 14 14 
9 0 14 0 0 14 0 14 0 14 0 0 0 14 14 14 14 14 14 14 14 14 0 0 0 0 14 0 14 0 0 8 
9 0 0 0 14 14 0 0 0 14 0 7 0 14 0 0 14 0 0 0 0 14 0 0 0 14 0 0 14 0 0 8 
14 0 14 14 14 14 14 14 14 14 14 14 14 14 0 0 14 0 0 0 0 0 14 0 0 14 0 0 0 14 0 8 
9 0 0 0 0 0 0 14 0 0 0 0 0 0 0 0 14 0 0 0 14 0 14 0 0 14 0 0 0 14 0 8 
9 0 14 14 14 14 0 14 0 14 14 14 14 14 0 0 0 14 0 0 14 0 0 14 0 0 14 14 0 14 0 8 
9 0 0 14 0 0 0 14 0 0 0 0 0 14 0 0 0 0 14 0 14 0 0 14 0 0 0 14 0 14 0 8 
9 0 0 14 0 14 14 14 0 0 0 0 0 0 0 0 0 0 14 0 14 0 0 0 14 0 0 14 0 14 0 8 
9 0 0 0 0 14 0 0 0 0 14 0 14 14 14 14 0 0 14 0 14 0 0 0 14 0 14 14 0 14 0 8 
9 0 0 0 14 14 14 14 14 0 14 0 0 14 0 0 0 0 14 0 14 0 0 0 14 0 14 0 0 14 0 8 
9 0 0 0 0 0 0 0 14 0 14 0 0 14 14 0 0 0 14 0 14 0 0 0 14 0 14 0 0 14 0 8 
9 0 0 0 0 14 14 14 14 0 14 0 0 0 14 0 0 0 14 0 14 0 0 0 14 0 14 0 0 0 0 8 
9 0 0 0 0 14 0 0 0 0 14 0 14 0 14 0 0 0 14 0 14 0 0 0 14 0 14 0 0 0 0 8 
9 0 0 0 0 14 0 0 14 14 0 0 14 0 0 14 0 0 0 0 0 14 0 0 14 0 14 0 0 0 0 8 
9 0 0 0 0 0 0 14 0 0 0 0 14 0 0 0 14 0 0 0 0 14 0 0 14 0 14 0 0 0 0 8 
9 0 0 0 0 0 14 14 0 0 14 14 0 0 0 0 14 14 14 14 14 14 0 0 14 0 14 0 0 0 0 8 
14 0 0 14 0 0 14 0 0 0 0 14 0 0 0 0 0 0 0 0 0 14 0 0 14 0 0 14 0 0 0 8 
13 13 13 13 13 13 13 13 13 13 13 0 0 0 0 0 0 0 0 0 0 14 0 0 14 0 0 14 0 0 0 8 
14 0 0 0 14 0 0 0 14 0 13 13 13 13 13 13 13 13 13 13 0 14 0 0 0 0 0 14 0 0 0 8 
9 0 14 0 0 0 14 0 0 0 0 0 0 0 0 0 0 0 0 0 0 14 0 0 0 0 0 14 0 0 0 8 
12 12 12 12 12 12 12 12 12 12 12 12 12 12 12 12 12 12 12 12 12 12 12 12 12 12 12 12 12 12 12 12 
