12 12 12 12 12 12 12 12 12 12 12 12 12 12 12 12 12 12 12 12 12 12 12 12 12 12 12 12 12 12 12 12 
9 0 0 0 0 0 0 0 0 0 14 0 0 0 0 0 0 0 0 0 14 0 0 0 0 0 0 0 0 0 7 14 
9 0 14 14 14 14 14 14 14 0 14 0 14 14 14 14 14 14 14 0 14 0 14 14 14 14 14 14 14 14 14 14 
14 14 14 14 0 0 0 0 0 0 14 0 14 0 14 0 0 0 14 0 14 0 14 0 0 0 0 0 14 0 0 8 
9 0 0 14 0 14 14 14 14 14 14 0 14 0 14 0 14 0 14 0 14 0 14 0 14 14 14 0 14 0 0 14 
9 0 0 14 0 0 0 0 0 0 0 0 14 0 14 0 14 0 0 0 14 0 14 0 14 0 0 0 14 0 0 8 
9 0 0 14 14 14 14 14 14 14 14 14 14 0 14 0 14 14 14 14 14 0 14 0 14 14 14 0 14 0 0 14 
9 0 0 0 0 0 0 0 0 14 0 0 0 0 14 0 0 0 0 0 0 0 14 0 0 0 14 0 14 0 0 8 
9 0 14 14 14 14 14 14 0 14 0 0 14 0 14 14 14 14 14 14 14 14 14 14 14 0 14 0 0 14 0 14 
9 0 0 0 0 0 0 0 0 14 0 0 14 0 0 0 14 0 0 0 14 0 0 0 14 0 14 0 0 0 0 8 
9 0 14 0 0 0 0 0 0 0 14 0 14 14 14 0 14 0 14 0 14 0 14 0 14 0 14 0 14 0 0 14 
9 0 0 14 0 0 0 0 14 0 14 0 14 0 0 0 14 0 14 0 14 0 14 0 14 0 14 0 14 0 0 8 
9 0 0 14 0 0 0 0 14 0 14 0 14 0 14 14 14 0 14 0 14 0 14 0 14 0 14 0 0 14 0 14 
9 0 14 0 0 14 0 0 14 0 14 0 14 0 14 0 0 0 14 0 14 0 14 0 14 0 14 0 0 14 0 8 
9 0 0 0 14 0 0 0 14 0 14 0 14 0 14 0 14 14 14 0 14 0 14 0 14 0 14 0 0 14 0 14 
9 0 14 14 14 0 14 14 14 0 14 0 14 0 14 0 14 0 0 0 14 0 14 0 0 0 14 0 14 0 0 8 
9 0 0 0 0 0 0 0 14 0 0 0 14 0 0 0 14 0 0 0 14 0 14 14 14 14 0 0 14 0 0 8 
9 0 14 14 14 14 14 14 14 14 14 14 14 14 14 14 14 14 0 14 14 0 0 0 0 14 0 0 14 0 0 14 
9 0 14 11 11 11 11 11 14 0 0 0 0 14 0 0 0 14 0 14 0 0 0 14 0 14 0 0 0 14 0 8 
9 0 14 11 2 2 2 11 14 0 0 0 0 14 0 14 0 14 0 14 14 14 14 14 0 14 0 14 0 14 0 14 
9 0 14 11 2 2 2 2 0 0 0 14 0 14 0 14 0 14 0 0 0 0 0 0 0 14 0 0 0 0 0 8 
9 0 14 11 30 2 2 2 0 0 0 14 0 14 0 14 0 14 14 14 14 14 14 14 14 14 14 14 14 14 14 14 
9 0 14 11 2 2 2 11 0 0 0 14 0 0 0 14 0 0 0 0 0 0 0 0 0 0 0 0 0 0 0 8 
12 12 12 11 11 11 11 11 12 12 12 12 12 12 12 12 12 12 12 12 12 12 12 12 12 12 12 12 12 12 12 12 
