12 12 12 12 12 12 12 12 12 12 12 12 12 12 12 12 12 12 12 12 12 12 12 12 12 12 12 12 12 12 12 12 
14 7 0 0 0 0 0 0 0 0 0 14 0 0 0 14 0 14 0 0 0 14 0 0 0 14 0 0 0 14 0 8 
14 14 14 14 14 14 14 14 14 14 0 14 0 14 0 14 0 14 0 14 0 14 0 14 0 14 0 14 0 14 0 8 
9 0 0 0 0 0 0 0 0 0 0 14 0 14 0 14 0 14 0 14 0 14 0 14 0 14 0 14 0 0 0 8 
14 14 14 14 14 14 14 14 14 14 14 14 0 14 0 14 0 14 0 14 0 14 0 14 0 14 0 14 14 14 14 14 
9 0 0 0 0 0 0 0 0 0 0 0 0 14 0 14 0 14 0 14 0 14 0 14 0 14 0 14 0 0 0 8 
14 14 14 14 14 14 14 14 14 14 14 14 14 14 0 14 0 14 0 14 0 14 0 14 0 14 0 14 0 0 0 8 
9 0 0 0 0 0 0 0 0 0 0 0 0 14 0 14 0 14 0 14 0 14 0 14 0 14 0 14 0 0 0 8 
14 14 14 14 14 14 14 14 14 14 14 14 0 14 0 0 0 14 0 14 0 14 0 14 0 0 0 14 0 0 0 8 
9 0 0 0 0 0 0 0 0 0 0 14 0 14 14 14 14 0 0 14 0 14 0 14 14 14 14 14 14 14 0 8 
14 14 14 14 14 14 14 14 14 14 0 14 0 0 0 0 0 0 0 14 0 14 0 14 0 0 0 0 0 14 0 8 
9 0 0 0 0 0 0 0 0 14 0 14 14 14 14 14 14 14 14 0 0 14 0 14 0 14 0 14 0 14 0 8 
14 14 14 14 14 14 14 14 14 14 0 14 0 0 0 0 0 0 0 0 0 14 0 14 0 14 0 14 0 14 0 8 
9 0 0 0 0 0 0 0 0 14 0 14 14 14 14 14 14 14 14 14 14 14 0 14 0 14 0 14 0 14 0 8 
14 14 14 14 14 14 14 14 0 14 0 0 0 0 0 0 0 0 0 0 0 0 0 14 0 14 0 14 0 14 0 8 
9 0 0 0 0 0 0 14 0 14 14 14 14 14 14 14 14 14 14 14 14 14 14 14 0 14 0 14 0 14 0 8 
9 0 0 0 0 0 0 14 0 0 0 0 0 0 0 0 0 0 0 0 0 0 0 0 0 14 0 14 0 14 0 8 
14 14 14 14 14 14 0 14 14 14 14 14 14 14 14 14 14 14 14 14 14 14 14 14 14 14 0 14 0 14 0 8 
9 0 0 0 0 14 0 0 0 0 0 0 0 0 0 0 0 0 0 0 14 0 0 0 0 0 0 14 0 14 0 8 
14 14 14 14 0 14 14 14 14 14 14 14 14 14 14 14 14 14 14 14 14 14 14 14 14 14 14 14 0 14 0 8 
9 0 0 0 0 0 0 0 0 0 14 0 0 0 0 0 0 0 0 0 0 0 0 0 0 0 0 0 0 14 14 14 
14 14 14 14 14 14 14 14 14 0 14 0 0 14 14 14 14 14 14 14 14 14 14 14 14 14 14 14 14 14 0 8 
9 0 0 0 0 0 0 0 0 0 14 0 0 0 0 0 0 0 0 0 0 0 0 0 0 0 0 0 0 0 0 8 
12 12 12 12 12 12 12 12 12 12 12 12 12 12 12 12 12 12 12 12 12 12 12 12 12 12 12 12 12 12 12 12 
